0000000000000000000000000000000000000000000000000000
000000000000XXXXXXXXX0000000000000000000000000000000
00000000222X000000000X222000000000000000000000000000
00000000000X00F000F00X000000000000000000000000000000
00000000222XW0000000WX222000000000000000000000000000
00000000000XXWWWWWWWXX000000000000000000000000000000
00000000222X000000000X222000000000000000000000000000
00000000000X000000000X000000000000000000000000000000
000000000000XWWWWWWWX0000000000000000000000000000000
0000000000001000000030000000000000000000000000000000
0000000000000000000000000000000000000000000000000000
0000000000000000000000000000000000000000000000000000
0000000000000000000000000000000000000000000000000000
0000000000000000000000000000000000000000000000000000
0000000000000000000000000000000000000000000000000000
0000000000000000000000000000000000000000000000000000
0000000000000000000000000000000000000000000000000000
0000000000000000000000000000000000000000000000000000
0000000000000000000000000000000000000000000000000000
2222222222222222222S22222222222222222222222222222222
0000000000000000000000000000000000000000000000000000
0000000000000000000000000000000000000000000000000000
0000000000000000000000000000000000000000000000000000
0000000000000000000000000000000000000000000000000000
0000000000000000000000000000000000000000000000000000
0000000000000000000000000000000000000000000000000000
0000000000000000000000000000000000000000000000000000
0000000000000000000000000000000000000000000000000000
0000000000000000000000000000000000000000000000000000
0000000000000000000000000000000000000000000000000000
0000000000000000000000000000000000000000000000000000
0000000000000000000000000000000000000000000000000000
2222222222222222222222222222222222222222222222222222
1222222222222222222222222222222222222222222222222223
