0000000000000000000000000000000000000000000000000000
0000000XXXXXXXXX000000000000000000000000000000000000
000222X000000000X22200000000000000000000000000000000
000000X00F000F00X00000000000000000000000000000000000
000222XW0000000WX22200000000000000000000000000000000
000000XXWWWWWWWXX00000000000000000000000000000000000
000222X000000000X22200000000000000000000000000000000
0000000XWWWWWWWX000000000000000000000000000000000000
0000000100000003000000000000000000000000000000000000
0000000000000000000000000000000000000000000000000000
0000000000000000000000000000000000000000000000000000
0000000000000000000000000000000000000000000000000000
0000000000000000000000000000000000000000000000000000
0000000000000000000000000000000000000000000000000000
0000000000000000000000000000000000000000000000000000
0000000000000000000000000000000000000000000000000000
0000000000000000000000000000000000000000000000000000
0000000000000000000000000000000000000000000000000000
2222222222222222222S22222222222222222222222222222222
0000000000000000000000000000000000000000000000000000
0000000000000000000000000000000000000000000000000000
0000000000000000000000000000000000000000000000000000
0000000000000000000000000000000000000000000000000000
0000000000000000000000000000000000000000000000000000
0000000000000000000000000000000000000000000000000000
0000000000000000000000000000000000000000000000000000
0000000000000000000000000000000000000000000000000000
0000000000000000000000000000000000000000000000000000
0000000000000000000000000000000000000000000000000000
0000000000000000000000000000000000000000000000000000
0000000000000000000000000000000000000000000000000000
2222222222222222222222222222222222222222222222222222
1222222222222222222222222222222222222222222222222223
