00000000XXX000000000FXXX1000000000000000000000000000
X0000000XXX0000000000XXX1000000000000000000000000000
000X0000X000XXXXXXXXXXXX1000000000000000000000000000
000X0000X000000X000000001000000000000000000000000000
000X0000X000000X000000001000000000000000000000000000
000X0000X000000X000X00001000000000000000000000000000
000X0000X000000X000X00001000000000000000000000000000
000X000000000000000000001000000000000000000000000000
0000X00000000000000000001000000000000000000000000000
000000X000000000000X00001000000000000000000000000000
00000000X0000000000X00001000000000000000000000000000
0000000000X00000000000001000000000000000000000000000
000XXX0000000000000000001000000000000000000000000000
0000000000000000000000001000000000000000000000000000
0000000X0000XXXX00000XXX1000000000000000000000000000
0000000X00000000000000001000000000000000000000000000
0000000X00000000000X00001000000000000000000000000000
0000XXXXXXX00000000X00001000000000000000000000000000
0000X0000000000X000X00001000000000000000000000000000
00S000000000000X000X00001000000000000000000000000000
00000000X000000X000X00001000000000000000000000000000
00000000X000000X000X00001000000000000000000000000000
XXXXXXXXXXXXXXXXXXXXXXXXX000000000000000000000000000
XXXXXXXXXXXXXXXXXXXXXXXXX000000000000000000000000000
XXXXXXXXXXXXXXXXXXXXXXXXX000000000000000000000000000
0000000000000000000000000000000000000000000000000000
0000000000000000000000000000000000000000000000000000
0000000000000000000000000000000000000000000000000000
0000000000000000000000000000000000000000000000000000
0000000000000000000000000000000000000000000000000000
0000000000000000000000000000000000000000000000000000
0000000000000000000000000000000000000000000000000000
